_________
|.......|
|.......|
|.......|
|.......|
|__---__|
.........
